action|åŠ¨ä½œ|The girls actions helped her team win the soccer game.
afraid|å®³æ€•|Our dog is afraid of thunder.
depend|ä¾é |Nick depends on his dad to help him learn to ride a bike.
nervously|ç´§å¼ åœ°|	Maya waited nervously for her swim race to begin.
peered|ç›¯ç€|The cat peered through the hole in the barn.
perfectly|å®Œç¾åœ°|	The orange is perfectly round .
rescue|è¥æ•‘|We watched the boy rescue the cat from the tree.
secret|ç§˜å¯†|Mandy whispered a secret to me.
aside|ä¸€è¾¹|Juan moves aside books on the shelf to find one he likes.
culture|æ–‡åŒ–|At Chinese New Year ,we learn about our culture.
fair|å…¬å¹³|Mom cut the cake so we all got our fair share.
invited|é‚€è¯·|I invited some friends to my birthday party.
language|è¯­è¨€|My friend Naomi speaks and writes in another language.
plead|ä¹æ±‚|I had to plead with Dad to get a new bike.
scurries|ç–¾èµ°|The squirrel scurries across the yard.
share|åˆ†äº«|I like to share music with my sister.
decide|å†³å®š|I decided to have juice and cereal for breakfast.
different|ä¸åŒ|The brown kitten is different than the orange kitten.
friendship|å‹è°Š|Because of their friendship, the kids played together a lot.
glance|ä¸€ç¥|I glance to see what book my sister is reading.
proper|åˆé€‚çš„|It is proper to wipe your mouth during a meal.
relationship|å…³ç³»|Our teacher has a good relationship with our class.
stares|æ³¨è§†|Helen stares at her friend.
trade|è´¸æ˜“|Don and Luis trade baseball cards.
allowed|å…è®¸|Dogs are not allowed on the beach.
care|å½“å¿ƒ|I help care for my little brother.
Excited|å…´å¥‹|The girls were excited to play with their new puppy.
Needs|éœ€è¦|Food and water are some of the needs of every animal.
Roam|å·¡è§†|Lions roam the plains in Africa.
Safe|å®‰å…¨|Wearing a seatbelt keeps me safe in the car.
Wandered|æ¸¸è¡|A bear cub wandered away from its mother.
Wild|é‡ç”Ÿ|Bears and raccoons live in the wild.
Check|æ£€æŸ¥|Mom will check to make sure Tina Â¡s helmet fits.
Choose|é€‰æ‹©|Julian will choose a shirt to wear.
Chores|å®¶åŠ¡æ´»|Sierra must finish her chores before she can play.
Cost|ä»·æ ¼|Jordan asked,how much does the shirt cost?
Customers|é¡¾å®¢|The customers lined up to buy lemonade.
Jobs|å·¥ä½œ|Nurse and doctor are two jobs at a hospital.
Spend|èŠ±è´¹|William decided to spend his money on snack.
Tools|å·¥å…·|Tom and his dad used tools to build a birdhouse.
adapt|é€‚åº”|The polar bear's thick fur coat helps it adapt to the icy water.
Climate|æ°”å€™|Tome lives a hot and sunny climate.
Eager|å…´å¥‹çš„|Mindy is eager to see her grandmother.
Freedom|è‡ªç”±|Deer have the freedom to move about the open land.
Fresh|æ–°é²œçš„|The backer made fresh bread every day.
Sense|æ„Ÿè§‰|I felt a sense of pride when I won the race.
Shadows|å½±å­|We made animal shadows on the wall.
Silence|å®‰é™çš„|The baby needed silence to fall asleep.
Buried|åŸ‹|The car was buried in the deep snow.
Escape|é€ƒè·‘|The cat could escape through a hole in the fence.
Habitat|ç”Ÿæ´»ç¯å¢ƒ|Prairie dogs live in a desert habitat.
Journey|æ—…ç¨‹|Maya and her family went on a journey in the woods.
Nature|è‡ªç„¶|We walk in the woods because we like to be in nature.
Peeks|ä¸€ç¥|While hiding, Kate peeks out from behind the tree.
Restless|èºåŠ¨çš„|The child became restless during the long car ride.
Spies|çª¥è§†|Carlos spies an eagle in the sky.
adult|æˆå¹´äºº|My father is an adult.
alive|æ´»ç€çš„|I water the flowers to keep them alive.
Covered|è¦†ç›–|Polar bears are covered with thick, white fur.
Fur|æ¯›|My kitten has fur that is soft and fluffy.
Giant|å·¨å¤§çš„|The giant tree is taller than my house.
Groom|åˆ·æ´—|I use a brush to groom my horse each day.
Mammal|å“ºä¹³åŠ¨ç‰©|A mammal has fur or hair and breathes air.
Offspring|åä»£|At the zoo, we saw a mother rabbit and two offspring.
Amazing|æƒŠå¥‡çš„|Jason made an amazing flip into the pool.
Force|åŠ›é‡|The force of my kick made the ball move far.
Measure|æµ‹é‡|I can measure the chalk with my ruler.
Objects|å¯¹è±¡|There were lots of objects in the toy chest.
Proved|è¯æ˜|Wyatt big hit proved he knew how to play baseball.
Speed|é€Ÿåº¦|The car moved at a very fast speed.
True|çœŸçš„|It is true that an elephant is the largest land animal.
Weight|é‡é‡|The weight of the pumpkin made it heavy to carry.
Adventure|å†’é™©|I want to travel around the world and find adventure.
Delighted|é«˜å…´çš„|Ling was delighted when her grandmother came to visit.
Dreamed|åšæ¢¦|Juan dreamed of being an actor when he grows up.
Enjoyed|äº«å—|We enjoyed playing in the pool on the hot day.
Grumbled|è‚šå­å’•å’•å«|My stomach grumbled because I was hungry.
Moonlight|æœˆå…‰|Moonlight can help sailors see at night.
Neighbor|é‚»å±…|I went across the street to play with my neighbor.
Nighttime|æ™šä¸Šæ—¶å…‰|I like to watch the stars at nighttime.
Across|ç©¿è¿‡|We walked across the street.
Borrow|å€Ÿ|I like to borrow books from the library in my town.
Countryside|éƒŠåŒº|The quiet countryside is full of grass and trees.
Idea|ä¸»æ„|Kate had an idea for how to make a paper crane.
Insists|åšæŒ|Mom insists we wear our seatbelts.
Lonely|å­¤ç‹¬|Gabe was lonely when his friend moved away.
Solution|è§£å†³åŠæ³•|Dylan found a solution for his problem.
Villages|å°é•‡|Few people live in the small villages on the mountain.
Damage|æŸå®³|The storm caused some damage to the tree.
Dangerous|å±é™©çš„|It is dangerous to ride a bike without a helmet.
Destroy|æ¯ç­|The puppy can destroy shoes by chewing on them.
Event|äº‹ä»¶|The party was a fun event with food and games.
Harsh|ä¸¥é…·çš„|The desert is harsh place to live.
Prevent|é˜²æ²»|You should wash your hands to prevent sickness.
Warning|è­¦å‘Š|Dark clouds are a warning that a storm is coming.
Weather|å¤©æ°”|The weather is cold and snowy today.
Cheered|æ¬¢å‘¼|We all cheered when our team won the game.
Concert|éŸ³ä¹ä¼š|Jack and luis played in the concert last night.
Instrument|ä¹å™¨|A violin is a musical instrument.
Movement|åŠ¨ä½œ|The dancersâ€™ movements were graceful.
Music|éŸ³ä¹|Kira played her favorite kind of music.
Rhythm|èŠ‚å¥|They tapped the rhythm of the song.
Sounds|å£°éŸ³|The triangle and drum make different sounds.
Understand|ç†è§£|Ken did not understand the homework.
Eerie|å¯æ€•çš„|The noises in the old barn gave me an eerie feeling.
Growth|å¢é•¿|I found a thick growth of ferns in the park.
Layers|å±‚|It was cold so I wore three layers of clothing.
Lively|å¯çˆ±çš„|The liveliy kitten played with a ball.
Location|ä½ç½®|I can find the location of my state on a map.
Region|åœ°åŒº|The arctic region is very cold and snowy.
Seasons|å­£èŠ‚|Summer is our favorite of all seasons.
Temperate|æ¸©å¸¦çš„|A temperate climate is not too hot or too cold.
Active|æ´»åŠ¨çš„|The active volcano was about to erupt.
Earth|åœ°çƒ|We drug into the earth to plant some lettuce.
Explode|çˆ†ç‚¸ğŸ’¥|Fireworks make bright colors and loud noises as they explode.
Island|å²›å±¿|We visited an island on our vacation.
Local|æœ¬åœ°çš„|Grandpa and I went to a local park.
properties|å±æ€§|I looked at the rock to learn about its properties.
Solid|å›ºä½“|Wood is solid, but water and air are not.
Steep|é™¡å³­çš„|This hill is steep and hard to climb.
Common|æ™®é€šçš„|Tag is a common game that children like.
Costume|æœè£…|Each actor in the play wore a colorful costume.
Customs|ä¹ ä¿—|A turkey dinner and a family gathering are Thanksgiving customs.
Favorite|æœ€å–œæ¬¢çš„|Autumn is our favorite seasons, because we like cool weather best.
Parades|æ¸¸è¡Œ|Our band marches in town parades.
Surrounded|åŒ…å›´|We were surrounded by flowers.
Travels|æ—…è¡Œ|The car travels along the road.
Wonder|æƒ³çŸ¥é“|I wonder when it will stop raining.
Ashamed|ç¾è€»çš„|Kim felt ashamed that she hurt her friendÂ¡Â¯s feelings.
Boast|è‡ªå¤¸|They always boast that they are the best team.
Dash|å†²å‡ºå»|People had to dash to get out of the rain.
Holler|å¤§å£°å–Šå«|I heard Sandy holler for her dog.
Plenty|å……è¶³çš„|There was plenty of fresh corn at the picnic.
Similarities|ç›¸ä¼¼æ€§|There are many similarities between my brother and me.
Victory|èƒœåˆ©|Winning the race was a great victory for our team.
Wisdom|æ™ºæ…§|Grandpa used his wisdom to help me solve my problem.
Champion|å† å†›ğŸ†|Maya won the game and became the new champion.
Determined|å†³å®š|The boy determined which books to check out at the library.
Issues|é—®é¢˜|The fireman talked about issues of fire safety with the children.
Promises|ä¿è¯|Zack and Jon made promises to tell the truth and stay friends.
Responsibility|è´£ä»»|It is my responsibility to clean my room every week.
Rights|æƒåˆ©|Going to school is one of your rights as a citizen.
Volunteered|å¿—æ„¿|I volunteered to help plant flowers in the garden.
Votes|æŠ•ç¥¨|I wonder who got the most votes in our class election.
Amused|å¨±ä¹|The kids told jokes and amused each other.
Cooperate|åˆä½œ|Runners must cooperate to win a relay race.
Describe|æè¿°|I would describe my cat as small and fluffy.
Entertained|å–æ‚¦|The funny clown entertained me.
Imagination|æƒ³è±¡åŠ›|Ryan used his imagination to pretend he was in space.
Interact|äº¤äº’|Mia likes to chat and interact with her friends at lunch.
Patient|è€å¿ƒçš„|The boy was patient and waited for his friend.
Peaceful|å¹³å’Œçš„|It was peaceful in the quiet library.
Agree|åŒæ„|Grandma and I agree to play a card game.
Challenging|æŒ‘æˆ˜|This hard math problem is challenging to me.
Discover|æ¢ç´¢|I dig in my backyard to discover buried treasure.
Heroes|è‹±é›„|Fire fighters are heroes that help people.
Interest|å…´è¶£|Adam has an interest in music.
Perform|æ¼”å‡º|My class likes to perform songs at school.
Study|å­¦ä¹ |I like to study the planets.
Succeed|æˆåŠŸ|I hope I succeed in winning the game.
Curious|å¥½å¥‡çš„|I am curious to find out what is in the box.
Distance|è·ç¦»|Lily waved from a distance, but her friend did not see her.
Earth resources|åœ°çƒèµ„æº|Water and trees are important Earth resources.
Enormous|å·¨å¤§çš„|The bird looked tiny on top of the enormous rhinoceros.
Gently|æ¸©æŸ”åœ°|The girls gently patted the puppy at the shelter.
Proudly|è‡ªè±ªçš„|Julia smiled proudly when she finished her painting.
Rarely|å¾ˆå°‘|It rarely rains in the dry desert.
Supply|ä¾›åº”|The teacher has a supply of colored pencils for the class.
Exclaimed|å«å–Š|what a surprise! James exclaimed.
Finally|æœ€ååœ°|The mail is finally at LiamÂ¡Â¯s house.
Form|æˆç«‹|Charlie and Dylan want to form a chess club.
History|å†å²|Ben learns about the history of his family.
Public|å…¬ä¼—çš„|The school playground is GinaÂ¡Â¯s favorite public place.
Rules|è§„åˆ™|We must follow the rules of our school.
United|è”åˆ|The children united to win the game.
Writers|ä½œè€…|The writers were busy finishing their stories.
Appeared|å‡ºç°|Buds appeared on the tree in early spring.
Crops|åº„ç¨¼|The farmer grows crops of corn and wheat.
Develop|å‘å±•|The tadpole will develop into a frog.
Edge|è¾¹ç¼˜|The ball rolled off the edge of the table.
Golden|é‡‘è‰²çš„|The golden sun shone in the blue sky.
Rustled|æ²™æ²™å£°|The leaved rustled in the wind.
Shining|é—ªäº®çš„|The shining flashlight made it easier for us to read the book at night.
Stages|é˜¶æ®µ|Egg, caterpillar, and butterfly are stages in a butterfly's life.
Electricity|ç”µèƒ½|The lights need electricity to work.
Energy|èƒ½é‡|It takes a lot of energy to power all the computers in our school.
Flows|æµåŠ¨|The water flows from the tap into the sink.
Haul|æ‹–|Dump trucks haul away big rocks.
Power|èƒ½é‡|The windmills use wind to make power for homes.
Silent|å®‰é™çš„|The classroom was silent.
Solar|å¤ªé˜³çš„|This solar oven uses light from the sun to cook food.
Underground|åœ°ä¸‹|Prairie dogs live underground.
Exploration|æ¢ç´¢|We studied plants during our exploration of the forest.
Important|é‡è¦çš„|It is important to get a good nightÂ¡Â¯s sleep.
Machines|æœºå™¨|Machines make it easier to cook in our kitchen.
Prepare|å‡†å¤‡|Hitting balls helps ben prepare for his baseball game.
Repair|ä¿®ç†|The plumber will repair the broken sink.
Result|ç»“æœ|The tree fell over as a result of the storm.
Scientific|ç§‘å­¦çš„|Our scientific study helped us learn about rocks.
Teamwork|å›¢é˜Ÿåä½œ|It takes teamwork to win a baseball game.